111111111111111111111111111111
110000000000000000000000000011
110000000000000000000000000011
110000000000000000000000000011
100000000000000000000000000001
100000000000000000000000000001
102000000000000000000000000301
100000000000000000000000000001
100000000000000000000000000001
110000000000000000000000000011
110000000000000000000000000011
110000000000000000000000000011
110000000000000000000000000011
111111111111111111111111111111